


#  C
#               S
#
#        L                    #
#           C                 #
#                     #       #
#            P        ####L  E#
###############################