



#
#
#                             #
#                     S#      #
#                    TD#      #
#            P        ####L  E#
#####################W#########